46 37
          #   ##       #  #  #  #    
     # #  # #  #  #  # ## #    #     
      #  #         # #    #   #      
   ##  ##  ##  #  #  #          #  # 
           #       # #   # #         
 #  #            #      #  ##   #    
              #  # #   #  #  #    ## 
                ##         ## #  ### 
#  #    #   ##     #   #   #        #
              #   #    #    #   #    
  #       ## #   ###          #  ## #
  # #  #     ##   #  # ##  #        #
  #   #       #    ####    # ###     
 #   # #         #      #  # ##      
  # #  #  # #  ##    #      #  #  ## 
 #  #     ##  ##  #     #      #  #  
 ## # #   #  #    #      #    #  ##  
 #  #  # # ##  # # #   #    #    #   
            #   #    #  #  # #       
                # #          #     ##
  #      ###   #     ## #    #     # 
##          ##      #           #   #
     #         ## ##      #   # # #  
 #   ##   # # #                     #
#         #    ###       ##   #  ##  
#   #   #   ## #  #  ###   #     ### 
       #  # #       ####   # #   ##  
###  # #              ## # # #  #  # 
#  #    #  ###  #   #   #   #   #    
                  #    #   #         
      #     #   ##  #   # ###  #  #  
#        # #  # #    # #          #  
# #  #        ##     ### # ##      ##
   #    #  ##     # # #              
        # ##    #     ##  ###    # # 
#   # ## #      ## #       #     #  #
   #      #  ## #     # #  #  ##     
     ##    #  # # #  #           ##  
 ##  #  ###           #       ##     
 ##     #  #    ##    #   #  #  # # #
 ## #   ## ## #    ##   ###    #     
####   ########          #    ##     
  # #      ## #       # #          ##
   #   #  #     #   # #              
 ##   #    # # #     #             # 
 #     # # #                   #     
