 @        #   ##       #  #  #  #    
 @   # #  # #  #  #  # ## #    #     
 @    #  #         # #    #   #      
 @ ##  ##  ##  #  #  #          #  # 
 @@        #       # #   # #         
 #@ #            #      #  ##   #    
  @           #  # #   #  #  #    ## 
  @             ##         ## #  ### 
# @#    #   ##     #   #   #        #
  @@          #   #    #    #   #    
  #@      ## #   ###          #  ## #
  #@#  #     ##   #  # ##  #        #
  #@  #       #    ####    # ###     
 # @ # #         #      #  # ##      
  #@#  #  # #  ##    #      #  #  ## 
 # @#     ##  ##  #     #      #  #  
 ##@# #   #  #    #      #    #  ##  
 # @#  # # ##  # # #   #    #    #   
   @        #   #    #  #  # #       
   @            # #          #     ##
  #@     ###   #     ## #    #     # 
## @        ##      #           #   #
   @ #         ## ##      #   # # #  
 # @ ##   # # #                     #
#  @      #    ###       ##   #  ##  
#  @#   #   ## #  #  ###   #     ### 
   @   #  # #       ####   # #   ##  
###@@# #              ## # # #  #  # 
#  #@   #  ###  #   #   #   #   #    
    @             #    #   #         
    @ #     #   ##  #   # ###  #  #  
#   @    # #  # #    # #          #  
# # @# @@@@@@@##     ### # ##      ##
   #@  @#@@##@    # # #              
    @@@@# ## @  #     ##  ###    # # 
#   # ## #   @@@## #       #     #  #
   #      #  ##@#     # #  #  ##     
     ##    #  #@# #  #           ##  
 ##  #  ###    @      #       ##     
 ##     #  #   @##    #   #  #  # # #
 ## #   ## ## #@   ##   ###    #     
####   ########@         #    ##     
  # #      ## #@      # #          ##
   #   #  #   @@#   # #              
 ##   #    # #@#     #        @@@  # 
 #     # # #  @@@@@@@@@@@@@@@@@#@@@@ 
