#@#####################
#@@@#@@@            # #
###@#@#@########### # #
# #@#@#@@@@@@@@@@@# # #
# #@#@# #########@# # #
# #@@@#     #@@@#@#   #
# ##### ### #@#@#@# ###
#     #   # #@#@@@#   #
##### # # # #@####### #
#     # # # #@@@@@@@# #
# ####### # #######@# #
# #       # #     #@# #
# # ####### # ### #@###
# # #       # #   #@@@#
# ### ######### # ###@#
#   #           #   #@#
# # #################@#
# #                  @#
#####################@#
