19 23
# #####################
#   #               # #
### # # ########### # #
# # # #           # # #
# # # # ######### # # #
# #   #     #   # #   #
# ##### ### # # # # ###
#     #   # # #   #   #
##### # # # # ####### #
#     # # # #       # #
# ####### # ####### # #
# #       # #     # # #
# # ####### # ### # ###
# # #       # #   #   #
# ### ######### # ### #
#   #           #   # #
# # ################# #
# #                   #
##################### #